8
########
E      #
### ####
S #    #
# #    #
# # ####
#   ####
########
