13
###################
#     #        #  #
#  ###   #  #  #  #
#  #     #  #     #
#  #  ##########  #
#  #  #           #
#  #  #######  #  #
#  #        #  #  #
#  #####    #  #  #
#     #     #  #  #
###   #   ###  #  #
#        #        #
#E########S########
